{
    "map":[
    {
            "id":           "START2",
            "dark":         "",
            "name":         "Detta är bara ett test",
            "floor":        "",
            "overlay":      "",
            "exit": {
                "up":       "",
                "right":    "ME0",
                "left":     "",
                "down":     ""
                },
            "tile":[
                [1,1,1,1,1,1,1,1,1,1,1,1,1,1,1],
                [1,1,1,1,1,1,1,1,1,1,1,1,1,1,1],
                [1,1,1,1,1,1,1,1,1,1,1,1,1,1,1],
                [1,1,1,1,1,1,1,1,1,1,1,1,1,1,1],
                [3,0,0,0,10,0,0,0,0,0,0,0,0,0,0],
                [1,1,1,1,1,1,1,1,1,1,1,1,1,1,1],
                [1,1,1,1,1,1,1,1,1,1,1,1,1,1,1],
                [1,1,1,1,1,1,1,1,1,1,1,1,1,1,1],
                [1,1,1,1,1,1,1,1,1,1,1,1,1,1,1],
                [1,1,1,1,1,1,1,1,1,1,1,1,1,1,1],
                [1,1,1,1,1,1,1,1,1,1,1,1,1,1,1],
                [1,1,1,1,1,1,1,1,1,1,1,1,1,1,1],
                [1,1,1,1,1,1,1,1,1,1,1,1,1,1,1],
                [1,1,1,1,1,1,1,1,1,1,1,1,1,1,1],
                [1,1,1,1,1,1,1,1,1,1,1,1,1,1,1]
    ]},
    {
            "id":           "ME99",
            "dark":         "",
            "name":         "Detta är bara ett test",
            "exit": {
                "up":       "",
                "right":    "",
                "left":     "",
                "down":     "ME2"
                },
            "tile":[
                [1,1,1,1,1,1,1,1,1,1,1,1,1,1,1],
                [1,1,1,1,1,1,1,1,1,1,1,1,1,1,1],
                [1,1,1,1,1,1,1,1,1,1,1,1,1,1,1],
                [1,1,1,1,1,1,1,1,1,1,1,1,1,1,1],
                [1,1,1,1,1,1,1,1,1,1,1,1,1,1,1],
                [1,1,1,1,1,1,1,1,1,1,1,1,1,1,1],
                [1,1,1,1,1,1,1,1,1,1,1,1,1,1,1],
                [1,1,1,1,1,1,1,1,1,1,1,1,1,1,1],
                [1,1,1,1,1,1,1,1,1,1,1,1,1,1,1],
                [1,1,1,1,1,1,1,1,1,1,1,1,1,1,1],
                [1,1,1,1,1,1,1,1,1,1,1,1,1,1,1],
                [1,1,1,1,1,1,1,1,1,1,1,1,1,1,1],
                [1,1,1,1,1,1,1,1,1,1,1,1,1,1,1],
                [1,1,1,1,1,1,1,1,1,1,1,1,1,1,1],
                [1,1,1,1,1,1,1,1,1,1,1,1,1,1,1]
    ]},
    {
            "id":           "ME98",
            "dark":         "",
            "name":         "Detta är bara ett test",
            "exit": {
                "up":       "",
                "right":    "",
                "left":     "",
                "down":     "ME2"
                },
            "tile":[
                [1,1,1,1,1,1,1,1,1,1,1,1,1,1,1],
                [1,0,0,0,0,0,0,0,0,0,0,0,0,0,1],
                [1,0,2,3,0,0,0,0,0,0,0,0,0,0,1],
                [1,0,0,0,0,0,0,0,0,0,0,0,0,0,1],
                [1,0,0,0,0,0,0,2,5,2,0,0,0,0,1],
                [1,0,0,0,0,0,0,0,0,0,0,0,0,0,1],
                [1,0,0,0,0,0,0,0,0,0,0,0,0,0,1],
                [1,0,0,0,0,0,9,9,0,0,9,0,0,0,1],
                [1,0,0,0,0,1,1,1,1,1,0,0,0,0,1],
                [1,0,0,0,0,4,1,0,0,0,0,0,0,0,1],
                [1,0,0,0,0,0,1,0,0,0,0,0,0,0,1],
                [1,0,0,0,0,0,1,6,0,1,0,0,0,0,1],
                [1,0,0,0,0,0,1,1,0,0,0,0,0,0,1],
                [1,0,0,0,0,0,0,0,0,0,0,0,0,0,1],
                [1,1,1,1,1,1,1,1,1,1,1,1,1,1,1]
    ]}
    ]   
}